###############################
#         #       #       #   #
######### ### ### # ##### ### #
#       #   #   #   #   #   # #
# # ####### # # ##### ##### # #
# #         # #   #       #   #
# ########### ### ##### ##### #
# #   #       #   #   #     # #
# ### # ##### # ### # # ### # #
#   #   #   # # #   # #   # # #
### ##### # ### # ### ### # # #
# #   #   #   #     # #   #   #
# ### # ##### ##### # ####### #
# #   # #   #   # # #       # #
# # ### # ##### # # ####### # #
# # #   #   #   #   #     # # #
# # # ### # # ### ### ##### ###
# #   # # #   #       #   #   #
# ##### # ########### # # ### #
#   #     #     #     # #   # #
# ### ####### # ####### ### # #
#   #     #   #         # # # #
### ##### # ############# # # #
#   #   #   #         #     # #
# ### # ##### ##### ### ##### #
#     #     #     #     #     #
# ####### # ##### ####### ### #
# #   # # # #   # #       #   #
# # # # # ### # # ### ##### ###
#   #   #     #       #       #
###############################
